
10010C00000C1
1100011C11001
1P0011E000001
1111111111111
